W W W W W W W W W W W W W W W W W W W W W W W W W W W
W S S S S S S S S S S S S W S S S S S S S S S S S S W
W S W W W W S W W W W W S W S W W W W W S W W W W S W
W S W W W W S W W W W W S W S W W W W W S W W W W S W
W S S S S S S S S S S S S S S S S S S S S S S S S S W
W S W W W W S W S W W W W W W W W W S W S W W W W S W
W S S S S S S W S S S S S W S S S S S W S S S S S S W
W W W W W W S W W W W W E W E W W W W W S W W W W W W
E E E E E W S W E E E E E E E E E E E W S W E E E E E
E E E E E W S W E W W W D D D W W W E W S W E E E E E
W W W W W W S W E W E E E E E E E W E W S W W W W W W
E E E E E E S E E W 1 E 2 E 3 E 4 W E E S E E E E E E
W W W W W W S W E W E E E E E E E W E W S W W W W W W
E E E E E W S W E W W W W W W W W W E W S W E E E E E
E E E E E W S W E E E E E E E E E E E W S W E E E E E
W W W W W W S W W W W W E W E W W W W W S W W W W W W
W S S S S S S W S S S S S W S S S S S W S S S S S S W
W S W W W W S W S W W W W W W W W W S W S W W W W S W
W S S S S S S S S S S S S S S S S S S S S S S S S S W
W S W W W W S W W W W W S W S W W W W W S W W W W S W
W S W W W W S W W W W W S W S W W W W W S W W W W S W
W S S S S S S S S S S S S W S S S S S S P S S S S S W
W W W W W W W W W W W W W W W W W W W W W W W W W W W